111111111111111111111
100100000C0C00000C111
100001111100100110111
1P0011E000001000000C1
111111111111111111111
