11111111111111
1000000P000001
10011111111101
1C00001110C101
11111000000101
10000000000101
10111111111101
10110C010000E1
100101010100C1
10000100010C11
11111111111111