111111111
1000P0001
1C11100C1
101100111
1001010E1
110100011
100000001
111111111